random_moves,optimized_hillclimber_moves,runtime,improvement,board,size,iterations
4089,3767,0.2229590415954589,322,Board 6,9x9,500
25561,25269,1.2928071022033691,292,Board 6,9x9,500
38495,38173,1.9592227935791016,322,Board 6,9x9,500
5599,5273,0.299901008605957,326,Board 6,9x9,500
17381,17381,0.8518791198730469,0,Board 6,9x9,500
10307,9945,0.5341091156005859,362,Board 6,9x9,500
6000,5654,0.3256242275238037,346,Board 6,9x9,500
10956,10624,0.5630731582641602,332,Board 6,9x9,500
36396,36086,1.825227975845337,310,Board 6,9x9,500
27175,26827,1.3785169124603271,348,Board 6,9x9,500
96907,96907,4.671431064605713,0,Board 6,9x9,500
5989,5663,0.3251593112945556,326,Board 6,9x9,500
30432,30098,1.522568941116333,334,Board 6,9x9,500
17912,17566,0.9480981826782228,346,Board 6,9x9,500
9710,9710,0.4769458770751953,0,Board 6,9x9,500
39750,39426,2.0427379608154297,324,Board 6,9x9,500
20106,19792,1.0508341789245603,314,Board 6,9x9,500
4707,4361,0.3325381278991699,346,Board 6,9x9,500
33275,32947,1.667099952697754,328,Board 6,9x9,500
53457,53131,2.673987865447998,326,Board 6,9x9,500
10570,10222,0.5676419734954834,348,Board 6,9x9,500
35126,34808,1.7988998889923096,318,Board 6,9x9,500
31646,31304,1.626053810119629,342,Board 6,9x9,500
17043,16707,0.8950259685516357,336,Board 6,9x9,500
35696,35358,1.8508422374725344,338,Board 6,9x9,500
29524,29202,1.522104024887085,322,Board 6,9x9,500
22128,21794,1.1426658630371094,334,Board 6,9x9,500
14233,13883,0.7451908588409424,350,Board 6,9x9,500
20021,19719,1.0467736721038818,302,Board 6,9x9,500
17288,17014,0.8989052772521973,274,Board 6,9x9,500
18726,18726,0.9521987438201904,0,Board 6,9x9,500
22762,22426,1.2098188400268557,336,Board 6,9x9,500
19349,19031,1.0556268692016602,318,Board 6,9x9,500
7029,6707,0.3804259300231933,322,Board 6,9x9,500
19743,19439,0.9423501491546632,304,Board 6,9x9,500
23201,22839,1.0803709030151367,362,Board 6,9x9,500
62471,62155,2.8412699699401855,316,Board 6,9x9,500
32963,32963,1.4890639781951904,0,Board 6,9x9,500
26625,26301,1.223518133163452,324,Board 6,9x9,500
25832,25464,1.1957058906555176,368,Board 6,9x9,500
14665,14313,0.682960033416748,352,Board 6,9x9,500
22150,21860,1.0154438018798828,290,Board 6,9x9,500
9141,8819,0.4276237487792969,322,Board 6,9x9,500
2223,1917,0.1165277957916259,306,Board 6,9x9,500
6636,6294,0.3234679698944092,342,Board 6,9x9,500
59203,58851,2.7062299251556396,352,Board 6,9x9,500
53219,52857,2.427403211593628,362,Board 6,9x9,500
10766,10450,0.50140380859375,316,Board 6,9x9,500
42566,42260,1.9364376068115232,306,Board 6,9x9,500
38748,38398,1.7641608715057373,350,Board 6,9x9,500
47184,46878,2.1366591453552246,306,Board 6,9x9,500
11121,11121,0.501859188079834,0,Board 6,9x9,500
2609,2309,0.1436340808868408,300,Board 6,9x9,500
29132,28770,1.3434929847717283,362,Board 6,9x9,500
26932,26586,1.2588210105895996,346,Board 6,9x9,500
30941,30941,1.3777940273284912,0,Board 6,9x9,500
15051,15051,0.6697752475738525,0,Board 6,9x9,500
66339,66017,2.9845027923583984,322,Board 6,9x9,500
11855,11521,0.5636849403381348,334,Board 6,9x9,500
23810,23464,1.0827927589416504,346,Board 6,9x9,500
26407,26067,1.212557077407837,340,Board 6,9x9,500
2247,1965,0.1231050491333007,282,Board 6,9x9,500
48668,48310,2.1942620277404785,358,Board 6,9x9,500
40838,40510,1.854626178741455,328,Board 6,9x9,500
5431,5091,0.2723629474639892,340,Board 6,9x9,500
15244,14924,0.7016482353210449,320,Board 6,9x9,500
38567,38231,1.7580788135528564,336,Board 6,9x9,500
39499,39149,1.8574042320251465,350,Board 6,9x9,500
23389,23075,1.183132886886597,314,Board 6,9x9,500
24841,24515,1.1279799938201904,326,Board 6,9x9,500
28741,28435,1.2945761680603027,306,Board 6,9x9,500
33266,32924,1.5709152221679688,342,Board 6,9x9,500
18097,17765,0.8348331451416016,332,Board 6,9x9,500
38629,38261,1.737128734588623,368,Board 6,9x9,500
11634,11634,0.5197958946228027,0,Board 6,9x9,500
16802,16476,0.7605018615722656,326,Board 6,9x9,500
54919,54577,2.514295816421509,342,Board 6,9x9,500
64917,64593,3.33115816116333,324,Board 6,9x9,500
27354,27052,1.392664909362793,302,Board 6,9x9,500
22046,21684,1.1451640129089355,362,Board 6,9x9,500
45641,45307,2.28067684173584,334,Board 6,9x9,500
76263,75939,3.92704701423645,324,Board 6,9x9,500
17660,17330,0.9199390411376952,330,Board 6,9x9,500
62876,62564,3.1445159912109375,312,Board 6,9x9,500
37450,37450,1.8840131759643557,0,Board 6,9x9,500
10448,10448,0.5257568359375,0,Board 6,9x9,500
25572,25572,1.2894508838653564,0,Board 6,9x9,500
11214,10870,0.5866539478302002,344,Board 6,9x9,500
11218,10860,0.5831968784332275,358,Board 6,9x9,500
42043,42043,2.094332218170166,0,Board 6,9x9,500
6710,6366,0.3726470470428467,344,Board 6,9x9,500
9516,9166,0.5102310180664062,350,Board 6,9x9,500
19901,19567,1.028662919998169,334,Board 6,9x9,500
11347,10997,0.608893871307373,350,Board 6,9x9,500
38182,37838,2.2166690826416016,344,Board 6,9x9,500
43742,43742,2.986403703689575,0,Board 7,12x12,500
40469,40139,2.756509065628052,330,Board 7,12x12,500
53514,53212,3.6461970806121826,302,Board 7,12x12,500
33463,33137,2.274005174636841,326,Board 7,12x12,500
38085,37775,2.6285130977630615,310,Board 7,12x12,500
52222,51866,3.572007179260254,356,Board 7,12x12,500
59892,59538,4.062297105789185,354,Board 7,12x12,500
66449,66151,4.499323844909668,298,Board 7,12x12,500
90062,89700,5.533115863800049,362,Board 7,12x12,500
95935,95613,5.961081027984619,322,Board 7,12x12,500
53254,52890,3.6556379795074463,364,Board 7,12x12,500
17212,16874,1.1309211254119873,338,Board 7,12x12,500
39106,38766,2.519676923751831,340,Board 7,12x12,500
51056,50720,3.2339062690734863,336,Board 7,12x12,500
36640,36316,2.377619981765747,324,Board 7,12x12,500
50904,50574,3.3022825717926025,330,Board 7,12x12,500
34210,33946,2.126248836517334,264,Board 7,12x12,500
40192,39838,2.5195600986480713,354,Board 7,12x12,500
89834,89500,5.596451044082642,334,Board 7,12x12,500
92353,91973,6.170273065567017,380,Board 7,12x12,500
36696,36414,2.31783390045166,282,Board 7,12x12,500
26419,26091,1.678534746170044,328,Board 7,12x12,500
67155,66823,4.341246128082275,332,Board 7,12x12,500
69148,68832,4.508914947509766,316,Board 7,12x12,500
22763,22419,1.4561100006103516,344,Board 7,12x12,500
49029,48739,3.0639712810516357,290,Board 7,12x12,500
34117,33787,2.1330606937408447,330,Board 7,12x12,500
19089,18753,1.1953208446502686,336,Board 7,12x12,500
76314,75968,4.966173887252808,346,Board 7,12x12,500
84943,84625,5.556448221206665,318,Board 7,12x12,500
46515,46183,2.845884084701538,332,Board 7,12x12,500
64641,64309,3.9657161235809326,332,Board 7,12x12,500
44085,43781,2.7048091888427734,304,Board 7,12x12,500
66241,65897,4.1234471797943115,344,Board 7,12x12,500
62704,62412,3.806318998336792,292,Board 7,12x12,500
7799,7469,0.4954438209533691,330,Board 7,12x12,500
63480,63138,3.8510680198669434,342,Board 7,12x12,500
49938,49610,3.0739219188690186,328,Board 7,12x12,500
58009,57661,3.8697550296783447,348,Board 7,12x12,500
9659,9311,0.778660774230957,348,Board 7,12x12,500
41219,40883,2.5147831439971924,336,Board 7,12x12,500
76478,76158,4.672132968902588,320,Board 7,12x12,500
49177,48801,3.0741801261901855,376,Board 7,12x12,500
74824,74484,4.567205905914307,340,Board 7,12x12,500
92194,91870,5.618396043777466,324,Board 7,12x12,500
7859,7551,0.5126059055328369,308,Board 7,12x12,500
15355,14987,0.9826927185058594,368,Board 7,12x12,500
30560,30234,2.1231942176818848,326,Board 7,12x12,500
22798,22474,1.437169313430786,324,Board 7,12x12,500
83811,83491,5.323698043823242,320,Board 7,12x12,500
76393,76057,5.23278021812439,336,Board 7,12x12,500
91381,91057,5.699073076248169,324,Board 7,12x12,500
13212,12840,0.8569951057434082,372,Board 7,12x12,500
69536,69214,3.873213052749634,322,Board 7,12x12,500
45837,45837,2.4582860469818115,0,Board 7,12x12,500
39752,39412,2.1537790298461914,340,Board 7,12x12,500
17402,17060,0.9611239433288574,342,Board 7,12x12,500
75357,75017,4.0182459354400635,340,Board 7,12x12,500
4331,4007,0.249418020248413,324,Board 7,12x12,500
52578,52224,2.801630973815918,354,Board 7,12x12,500
69633,69257,4.1819798946380615,376,Board 7,12x12,500
63795,63523,4.242140769958496,272,Board 7,12x12,500
64823,64513,3.5642521381378174,310,Board 7,12x12,500
35106,34762,2.0563700199127197,344,Board 7,12x12,500
30160,29850,1.721991777420044,310,Board 7,12x12,500
21334,20974,1.2222568988800049,360,Board 7,12x12,500
33179,32831,1.9714760780334473,348,Board 7,12x12,500
76794,76486,3.436269044876098,308,Board 5,9x9,500
42994,42634,1.928812026977539,360,Board 5,9x9,500
10664,10664,0.455643892288208,0,Board 5,9x9,500
39427,39081,1.5687620639801023,346,Board 5,9x9,500
20567,20233,0.8404066562652588,334,Board 5,9x9,500
29114,29114,1.1479949951171875,0,Board 5,9x9,500
38225,37889,1.600327968597412,336,Board 5,9x9,500
68482,68158,2.9446957111358643,324,Board 5,9x9,500
77848,77512,3.5907089710235596,336,Board 5,9x9,500
52199,51899,2.384993076324463,300,Board 5,9x9,500
19973,19633,0.9311561584472656,340,Board 5,9x9,500
23700,23406,1.0990567207336426,294,Board 5,9x9,500
3932,3566,0.209763765335083,366,Board 5,9x9,500
85573,85267,4.144337892532349,306,Board 5,9x9,500
90385,90059,4.2654500007629395,326,Board 5,9x9,500
32872,32532,1.5629019737243652,340,Board 5,9x9,500
9435,9081,0.4661979675292969,354,Board 5,9x9,500
24627,24303,1.16192889213562,324,Board 5,9x9,500
82806,82444,3.885096788406372,362,Board 5,9x9,500
45782,45432,2.22052001953125,350,Board 5,9x9,500
56979,56647,2.6836981773376465,332,Board 5,9x9,500
25179,24811,1.20923113822937,368,Board 5,9x9,500
23456,23150,1.1187140941619873,306,Board 5,9x9,500
51122,50774,2.394596815109253,348,Board 5,9x9,500
29275,28899,1.392897129058838,376,Board 5,9x9,500
45605,45261,2.1995818614959717,344,Board 5,9x9,500
30466,30126,1.4556069374084473,340,Board 5,9x9,500
16360,16038,0.7989072799682617,322,Board 5,9x9,500
7838,7500,0.3999207019805908,338,Board 5,9x9,500
61823,61479,2.6209330558776855,344,Board 5,9x9,500
13564,13260,0.5920419692993164,304,Board 5,9x9,500
87011,86699,3.6428537368774414,312,Board 5,9x9,500
29407,29073,1.2640080451965332,334,Board 5,9x9,500
67351,66995,2.8624870777130127,356,Board 5,9x9,500
17021,16675,0.7462897300720215,346,Board 5,9x9,500
12740,12436,0.5494468212127686,304,Board 5,9x9,500
21326,21000,0.9007978439331056,326,Board 5,9x9,500
37227,36909,1.5732111930847168,318,Board 5,9x9,500
8717,8393,0.385343074798584,324,Board 5,9x9,500
25640,25282,1.0842900276184082,358,Board 5,9x9,500
17494,17148,0.7644431591033936,346,Board 5,9x9,500
83444,83144,3.5406980514526367,300,Board 5,9x9,500
37373,37007,1.5747997760772705,366,Board 5,9x9,500
18257,17903,0.7941598892211914,354,Board 5,9x9,500
21391,21059,0.9141881465911864,332,Board 5,9x9,500
15049,14699,0.6540498733520508,350,Board 5,9x9,500
81550,81224,3.3976917266845703,326,Board 5,9x9,500
6254,5940,0.2881231307983398,314,Board 5,9x9,500
19419,19115,0.8808612823486328,304,Board 5,9x9,500
63044,62658,2.7006871700286865,386,Board 5,9x9,500
34909,34577,1.4596247673034668,332,Board 5,9x9,500
93436,93080,4.07122802734375,356,Board 5,9x9,500
37583,37257,1.809715986251831,326,Board 5,9x9,500
36904,36548,1.8005788326263428,356,Board 5,9x9,500
41651,41651,1.900627851486206,0,Board 5,9x9,500
29189,28845,1.394032001495361,344,Board 5,9x9,500
70720,70390,3.363356113433838,330,Board 5,9x9,500
27696,27378,1.30663800239563,318,Board 5,9x9,500
11088,10738,0.5430989265441895,350,Board 5,9x9,500
33912,33564,1.591296911239624,348,Board 5,9x9,500
24563,24245,1.1948952674865725,318,Board 5,9x9,500
7478,7118,0.3900158405303955,360,Board 5,9x9,500
15211,14883,0.7488481998443604,328,Board 5,9x9,500
12928,12594,0.6463019847869873,334,Board 5,9x9,500
2729,2387,0.1509320735931396,342,Board 5,9x9,500
69428,69078,3.429337739944458,350,Board 5,9x9,500
28351,28351,1.329885959625244,0,Board 5,9x9,500
57279,56923,2.6704061031341553,356,Board 5,9x9,500
30403,30035,1.4652609825134275,368,Board 5,9x9,500
33838,33494,1.848160982131958,344,Board 5,9x9,500
36484,36172,1.6305279731750488,312,Board 5,9x9,500
60613,60295,2.659658908843994,318,Board 5,9x9,500
38921,38619,1.7217559814453125,302,Board 5,9x9,500
24906,24626,1.1150190830230713,280,Board 5,9x9,500
21665,21333,0.9301550388336182,332,Board 5,9x9,500
20450,20100,0.975288152694702,350,Board 5,9x9,500
26065,25697,1.116441011428833,368,Board 5,9x9,500
69710,69402,2.9527719020843506,308,Board 5,9x9,500
56718,56718,2.363679885864258,0,Board 5,9x9,500
51366,51054,2.2073380947113037,312,Board 5,9x9,500
41203,40869,1.764112949371338,334,Board 5,9x9,500
19571,19203,0.8636882305145264,368,Board 5,9x9,500
59401,59059,2.9181759357452393,342,Board 5,9x9,500
23312,22988,1.055410861968994,324,Board 5,9x9,500
21887,21553,0.9570317268371582,334,Board 5,9x9,500
93712,93394,3.975468158721924,318,Board 5,9x9,500
98469,98137,4.148373126983643,332,Board 5,9x9,500
21647,21333,0.9319391250610352,314,Board 5,9x9,500
18490,18184,0.6112282276153564,306,Board 4,9x9,500
64885,64573,2.1317009925842285,312,Board 4,9x9,500
34730,34418,1.160092830657959,312,Board 4,9x9,500
27574,27258,0.9130239486694336,316,Board 4,9x9,500
40042,39728,1.310817003250122,314,Board 4,9x9,500
75837,75515,2.49124813079834,322,Board 4,9x9,500
23755,23423,0.7956211566925049,332,Board 4,9x9,500
25865,25561,0.8514587879180908,304,Board 4,9x9,500
24691,24311,0.8255276679992676,380,Board 4,9x9,500
19578,19218,0.6532993316650391,360,Board 4,9x9,500
27114,26768,0.8885300159454346,346,Board 4,9x9,500
19874,19572,0.6527988910675049,302,Board 4,9x9,500
19531,19531,0.673659086227417,0,Board 4,9x9,500
58923,58597,1.9277312755584717,326,Board 4,9x9,500
15107,15107,0.4955780506134033,0,Board 4,9x9,500
32740,32430,1.1044251918792725,310,Board 4,9x9,500
89755,89411,2.984917163848877,344,Board 4,9x9,500
53517,53201,1.965278148651123,316,Board 4,9x9,500
15643,15303,0.5930988788604736,340,Board 4,9x9,500
18258,17896,0.6870608329772949,362,Board 4,9x9,500
21530,21222,0.786189079284668,308,Board 4,9x9,500
45659,45351,1.6592020988464355,308,Board 4,9x9,500
40090,39780,1.459313154220581,310,Board 4,9x9,500
45736,45398,1.6656782627105713,338,Board 4,9x9,500
48408,48060,1.794386863708496,348,Board 4,9x9,500
20784,20444,0.7771761417388916,340,Board 4,9x9,500
13517,13209,0.5029871463775635,308,Board 4,9x9,500
36739,36739,1.3138198852539062,0,Board 4,9x9,500
23927,23581,0.9116737842559814,346,Board 4,9x9,500
41721,41353,1.553530216217041,368,Board 4,9x9,500
31082,30714,1.1724889278411863,368,Board 4,9x9,500
24933,24597,0.9349446296691896,336,Board 4,9x9,500
38535,38187,1.462795972824097,348,Board 4,9x9,500
15138,14828,0.6356768608093262,310,Board 4,9x9,500
29782,29468,1.1961588859558103,314,Board 4,9x9,500
33531,33203,1.2340118885040283,328,Board 4,9x9,500
50387,50045,1.8996970653533936,342,Board 4,9x9,500
13225,12925,0.4996659755706787,300,Board 4,9x9,500
23386,23046,0.8845241069793701,340,Board 4,9x9,500
11599,11271,0.446429967880249,328,Board 4,9x9,500
17066,16738,0.6460919380187988,328,Board 4,9x9,500
12672,12332,0.4898300170898437,340,Board 4,9x9,500
72686,72376,2.7056148052215576,310,Board 4,9x9,500
57454,57122,2.1307740211486816,332,Board 4,9x9,500
20739,20441,0.7901551723480225,298,Board 4,9x9,500
40603,40215,1.532702922821045,388,Board 4,9x9,500
12515,12199,0.4847249984741211,316,Board 4,9x9,500
13829,13515,0.5289669036865234,314,Board 4,9x9,500
27210,26868,1.122624158859253,342,Board 4,9x9,500
85305,84965,3.191316843032837,340,Board 4,9x9,500
44262,43948,1.6584358215332031,314,Board 4,9x9,500
16331,15965,0.6771469116210938,366,Board 4,9x9,500
37733,37381,1.5977871417999268,352,Board 4,9x9,500
66283,65957,2.8056480884552,326,Board 4,9x9,500
20216,19882,0.86515212059021,334,Board 4,9x9,500
62587,62237,2.430773973464966,350,Board 4,9x9,500
43548,43214,1.7036569118499756,334,Board 4,9x9,500
48445,48095,1.8358471393585205,350,Board 4,9x9,500
78702,78702,2.9933929443359375,0,Board 4,9x9,500
66525,66191,2.640026807785034,334,Board 4,9x9,500
61873,61529,2.679190158843994,344,Board 4,9x9,500
46286,45942,2.0701711177825928,344,Board 4,9x9,500
32278,31964,1.393021821975708,314,Board 4,9x9,500
11854,11504,0.5411562919616699,350,Board 4,9x9,500
46865,46523,2.039587020874023,342,Board 4,9x9,500
59823,59487,2.565412998199463,336,Board 4,9x9,500
14369,14025,0.6473307609558105,344,Board 4,9x9,500
28930,28586,1.296553134918213,344,Board 4,9x9,500
51138,50774,2.228752851486206,364,Board 4,9x9,500
34712,34396,1.5057783126831057,316,Board 4,9x9,500
11267,10963,0.500248908996582,304,Board 4,9x9,500
34736,34428,1.5202171802520752,308,Board 4,9x9,500
9240,8904,0.4174797534942627,336,Board 4,9x9,500
9522,9202,0.4692690372467041,320,Board 4,9x9,500
40863,40557,1.7772748470306396,306,Board 4,9x9,500
17757,17755,0.8011269569396973,2,Board 4,9x9,500
16657,16657,0.7322938442230225,0,Board 4,9x9,500
53806,53438,2.4508440494537354,368,Board 4,9x9,500
27699,27699,1.1866772174835205,0,Board 4,9x9,500
16350,16008,0.730118989944458,342,Board 4,9x9,500
35572,35258,1.581403732299805,314,Board 4,9x9,500
32337,31959,1.437704086303711,378,Board 4,9x9,500
11725,11389,0.5589959621429443,336,Board 4,9x9,500
26801,26491,1.1730737686157229,310,Board 4,9x9,500
46537,46209,2.057697057723999,328,Board 4,9x9,500
9553,9225,0.4473540782928467,328,Board 4,9x9,500
53386,53064,2.4056291580200195,322,Board 4,9x9,500
59595,59225,2.6489200592041016,370,Board 4,9x9,500
21521,21183,0.9562430381774902,338,Board 4,9x9,500
49823,49475,2.2260780334472656,348,Board 4,9x9,500
7983,7657,0.3675277233123779,326,Board 4,9x9,500
20022,19692,0.897108793258667,330,Board 4,9x9,500
39671,39327,1.7647078037261963,344,Board 4,9x9,500
42476,42160,1.8947367668151855,316,Board 4,9x9,500
33980,33666,1.5135879516601562,314,Board 4,9x9,500
22552,22194,1.095567226409912,358,Board 4,9x9,500
25160,24814,1.156483173370361,346,Board 4,9x9,500
11526,11526,0.4979367256164551,0,Board 4,9x9,500
18422,18096,0.8663458824157715,326,Board 4,9x9,500
3126,2766,0.1049191951751709,360,Board 1,6x6,500
9521,9179,0.2718768119812011,342,Board 1,6x6,500
75335,74993,2.091331958770752,342,Board 1,6x6,500
19357,19005,0.544072151184082,352,Board 1,6x6,500
38979,38655,1.0854361057281494,324,Board 1,6x6,500
4911,4589,0.1423659324645996,322,Board 1,6x6,500
15300,14958,0.4269037246704101,342,Board 1,6x6,500
5836,5530,0.164802074432373,306,Board 1,6x6,500
5097,4783,0.145190954208374,314,Board 1,6x6,500
2119,1777,0.0623219013214111,342,Board 1,6x6,500
10030,9714,0.2796518802642822,316,Board 1,6x6,500
8551,8225,0.2404360771179199,326,Board 1,6x6,500
3200,2800,0.0961263179779052,400,Board 1,6x6,500
8855,8509,0.2497060298919677,346,Board 1,6x6,500
10194,9852,0.286478042602539,342,Board 1,6x6,500
5042,4710,0.1440591812133789,332,Board 1,6x6,500
3532,3200,0.1029722690582275,332,Board 1,6x6,500
2648,2282,0.078402042388916,366,Board 1,6x6,500
5439,5069,0.1572291851043701,370,Board 1,6x6,500
5421,5123,0.1546111106872558,298,Board 1,6x6,500
7241,6891,0.2056310176849365,350,Board 1,6x6,500
7128,6774,0.2014951705932617,354,Board 1,6x6,500
23775,23419,0.6575422286987305,356,Board 1,6x6,500
860,540,0.0314178466796875,320,Board 1,6x6,500
26509,26183,0.738696813583374,326,Board 1,6x6,500
8384,8036,0.238508939743042,348,Board 1,6x6,500
25636,25290,0.7097032070159912,346,Board 1,6x6,500
5867,5523,0.1694190502166748,344,Board 1,6x6,500
5876,5538,0.167668342590332,338,Board 1,6x6,500
15881,15529,0.4416918754577636,352,Board 1,6x6,500
5937,5587,0.169464111328125,350,Board 1,6x6,500
15301,14927,0.4268097877502441,374,Board 1,6x6,500
12066,11688,0.3366508483886719,378,Board 1,6x6,500
10907,10573,0.3056898117065429,334,Board 1,6x6,500
2493,2147,0.0753381252288818,346,Board 1,6x6,500
19330,18994,0.5342509746551514,336,Board 1,6x6,500
1295,987,0.0412380695343017,308,Board 1,6x6,500
18825,18517,0.5220351219177246,308,Board 1,6x6,500
13731,13363,0.3850302696228027,368,Board 1,6x6,500
21782,21456,0.6040089130401611,326,Board 1,6x6,500
2076,1754,0.0625221729278564,322,Board 1,6x6,500
5976,5612,0.1703429222106933,364,Board 1,6x6,500
10793,10465,0.3032870292663574,328,Board 1,6x6,500
27642,27340,0.7673547267913818,302,Board 1,6x6,500
1323,975,0.0411012172698974,348,Board 1,6x6,500
7147,6871,0.2002160549163818,276,Board 1,6x6,500
5677,5361,0.160715103149414,316,Board 1,6x6,500
1463,1125,0.0463809967041015,338,Board 1,6x6,500
24858,24518,0.6868579387664795,340,Board 1,6x6,500
20465,20129,0.5730748176574707,336,Board 1,6x6,500
15057,14707,0.4217920303344726,350,Board 1,6x6,500
13059,12745,0.3641011714935303,314,Board 1,6x6,500
19309,18971,0.5354223251342773,338,Board 1,6x6,500
19491,19163,0.5389580726623535,328,Board 1,6x6,500
3105,2783,0.0911910533905029,322,Board 1,6x6,500
2247,1851,0.068387746810913,396,Board 1,6x6,500
42219,41869,1.1624870300292969,350,Board 1,6x6,500
17833,17513,0.5044379234313965,320,Board 1,6x6,500
8027,7647,0.2289590835571289,380,Board 1,6x6,500
23496,23140,0.6559011936187744,356,Board 1,6x6,500
2331,1969,0.0715909004211425,362,Board 1,6x6,500
7639,7303,0.2169220447540283,336,Board 1,6x6,500
6048,5750,0.1705751419067382,298,Board 1,6x6,500
23614,23272,0.657742977142334,342,Board 1,6x6,500
2184,1858,0.0655291080474853,326,Board 1,6x6,500
10905,10601,0.3040401935577392,304,Board 1,6x6,500
16218,15862,0.4515581130981445,356,Board 1,6x6,500
6359,6047,0.1791679859161377,312,Board 1,6x6,500
16181,15813,0.4508979320526123,368,Board 1,6x6,500
14551,14257,0.4012651443481445,294,Board 1,6x6,500
21338,21012,0.6071822643280029,326,Board 1,6x6,500
14899,14585,0.4129579067230224,314,Board 1,6x6,500
9409,9083,0.2634129524230957,326,Board 1,6x6,500
8171,7867,0.2281868457794189,304,Board 1,6x6,500
9755,9423,0.2707960605621338,332,Board 1,6x6,500
8465,8135,0.2367072105407714,330,Board 1,6x6,500
4135,3793,0.1188368797302246,342,Board 1,6x6,500
14548,14208,0.4050929546356201,340,Board 1,6x6,500
10291,10031,0.2842981815338135,260,Board 1,6x6,500
2483,2147,0.0735809803009033,336,Board 1,6x6,500
10700,10370,0.2991430759429931,330,Board 1,6x6,500
9372,9012,0.2637219429016113,360,Board 1,6x6,500
22022,21714,0.6069610118865967,308,Board 1,6x6,500
20724,20400,0.5756831169128418,324,Board 1,6x6,500
55150,54834,1.520923137664795,316,Board 1,6x6,500
7095,6739,0.2049829959869384,356,Board 1,6x6,500
5077,4743,0.146158218383789,334,Board 1,6x6,500
5037,4729,0.1428017616271972,308,Board 1,6x6,500
18420,18104,0.5085461139678955,316,Board 1,6x6,500
1629,1309,0.050832986831665,320,Board 1,6x6,500
50690,50384,1.3888700008392334,306,Board 1,6x6,500
841,509,0.0314249992370605,332,Board 1,6x6,500
7819,7465,0.2213990688323974,354,Board 1,6x6,500
3428,3102,0.0995929241180419,326,Board 1,6x6,500
2749,2377,0.0821120738983154,372,Board 1,6x6,500
1390,1072,0.0435459613800048,318,Board 1,6x6,500
47025,46681,1.2944660186767578,344,Board 1,6x6,500
4992,4664,0.14540696144104,328,Board 1,6x6,500
9521,9189,0.2679481506347656,332,Board 1,6x6,500
5783,5459,0.1638219356536865,324,Board 1,6x6,500
19232,18874,0.4611871242523193,358,Board 3,6x6,500
22115,21785,0.5201590061187744,330,Board 3,6x6,500
30133,29807,0.9421720504760742,326,Board 3,6x6,500
67699,67339,1.5873363018035889,360,Board 3,6x6,500
55438,55438,1.241650104522705,0,Board 3,6x6,500
45818,45464,1.1415560245513916,354,Board 3,6x6,500
49123,48781,1.1549310684204102,342,Board 3,6x6,500
5785,5455,0.1472067832946777,330,Board 3,6x6,500
6306,5982,0.1902570724487304,324,Board 3,6x6,500
64145,63831,1.4713118076324463,314,Board 3,6x6,500
15366,15042,0.3632609844207763,324,Board 3,6x6,500
19090,18748,0.4501130580902099,342,Board 3,6x6,500
6845,6501,0.16876220703125,344,Board 3,6x6,500
83579,83263,1.9659967422485352,316,Board 3,6x6,500
12458,12456,0.2853939533233642,2,Board 3,6x6,500
10937,10593,0.2623500823974609,344,Board 3,6x6,500
41826,41508,1.011368989944458,318,Board 3,6x6,500
40380,40050,0.937053918838501,330,Board 3,6x6,500
9685,9685,0.2205150127410888,0,Board 3,6x6,500
36023,35697,0.8360152244567871,326,Board 3,6x6,500
96477,96179,2.212929964065552,298,Board 3,6x6,500
61544,61232,1.426408290863037,312,Board 3,6x6,500
70246,69872,1.6298189163208008,374,Board 3,6x6,500
29197,28853,0.6839370727539062,344,Board 3,6x6,500
22292,22292,0.4998152256011963,0,Board 3,6x6,500
66021,65701,1.518643140792847,320,Board 3,6x6,500
20948,20614,0.4938142299652099,334,Board 3,6x6,500
4391,4049,0.1117959022521972,342,Board 3,6x6,500
8539,8209,0.2070131301879882,330,Board 3,6x6,500
76455,76123,1.7526562213897705,332,Board 3,6x6,500
3475,3161,0.0901050567626953,314,Board 3,6x6,500
6268,5912,0.1529407501220703,356,Board 3,6x6,500
28723,28411,0.667604923248291,312,Board 3,6x6,500
31823,31539,0.7327799797058105,284,Board 3,6x6,500
26768,26420,0.6227569580078125,348,Board 3,6x6,500
13130,13130,0.2943930625915527,0,Board 3,6x6,500
19159,18805,0.4526050090789795,354,Board 3,6x6,500
41096,40742,0.9523818492889404,354,Board 3,6x6,500
69174,68840,1.5862019062042236,334,Board 3,6x6,500
95660,95306,2.230271100997925,354,Board 3,6x6,500
86755,86429,1.9912848472595217,326,Board 3,6x6,500
32862,32538,0.7660958766937256,324,Board 3,6x6,500
20246,19912,0.4770400524139404,334,Board 3,6x6,500
17625,17281,0.4180030822753906,344,Board 3,6x6,500
8163,8163,0.1867399215698242,0,Board 3,6x6,500
75773,75429,1.7429897785186768,344,Board 3,6x6,500
3849,3849,0.0911288261413574,0,Board 3,6x6,500
69576,69262,1.5872550010681152,314,Board 3,6x6,500
36051,35715,0.834388017654419,336,Board 3,6x6,500
7726,7374,0.1892998218536377,352,Board 3,6x6,500
23522,23176,0.5521080493927002,346,Board 3,6x6,500
51479,51147,1.1859352588653564,332,Board 3,6x6,500
9494,9488,0.2140960693359375,6,Board 3,6x6,500
8515,8165,0.2053000926971435,350,Board 3,6x6,500
95304,95304,2.1135432720184326,0,Board 3,6x6,500
34065,33715,0.7955448627471924,350,Board 3,6x6,500
88394,88030,2.0255050659179688,364,Board 3,6x6,500
31450,31110,0.7341561317443848,340,Board 3,6x6,500
39553,39213,1.1951117515563965,340,Board 3,6x6,500
6312,5988,0.1553530693054199,324,Board 3,6x6,500
12658,12314,0.302192211151123,344,Board 3,6x6,500
38025,37717,0.931471824645996,308,Board 3,6x6,500
10568,10260,0.2530250549316406,308,Board 3,6x6,500
14580,14248,0.3398821353912353,332,Board 3,6x6,500
6748,6438,0.1636769771575927,310,Board 3,6x6,500
13314,13000,0.3106000423431396,314,Board 3,6x6,500
47505,47203,1.1078178882598877,302,Board 3,6x6,500
29154,28798,0.6802058219909668,356,Board 3,6x6,500
28645,28309,0.6601860523223877,336,Board 3,6x6,500
2744,2742,0.0633308887481689,2,Board 3,6x6,500
45473,45189,1.035970687866211,284,Board 3,6x6,500
49726,49726,1.144831895828247,0,Board 3,6x6,500
11203,10899,0.2967753410339355,304,Board 3,6x6,500
3664,3346,0.0925235748291015,318,Board 3,6x6,500
64576,64228,1.485166072845459,348,Board 3,6x6,500
51183,50877,1.1745169162750244,306,Board 3,6x6,500
28836,28488,0.7456278800964355,348,Board 3,6x6,500
61495,61125,1.723888874053955,370,Board 3,6x6,500
11760,11470,0.3415427207946777,290,Board 3,6x6,500
18742,18362,0.5496001243591309,380,Board 3,6x6,500
12023,11665,0.3446319103240967,358,Board 3,6x6,500
21668,21342,0.6155369281768799,326,Board 3,6x6,500
45048,45048,1.2237627506256104,0,Board 3,6x6,500
21176,20856,0.590749979019165,320,Board 3,6x6,500
36669,36333,1.0031452178955078,336,Board 3,6x6,500
27193,26865,0.7859029769897461,328,Board 3,6x6,500
31121,30787,0.861274242401123,334,Board 3,6x6,500
17616,17276,0.4935767650604248,340,Board 3,6x6,500
4744,4416,0.1370129585266113,328,Board 3,6x6,500
70038,69712,1.9296939373016355,326,Board 3,6x6,500
44915,44565,1.160254955291748,350,Board 3,6x6,500
69769,69439,1.6143150329589844,330,Board 3,6x6,500
97955,97625,2.2751622200012207,330,Board 3,6x6,500
31467,31129,0.7369837760925293,338,Board 3,6x6,500
31091,30753,0.7249388694763184,338,Board 3,6x6,500
7296,6960,0.2162139415740966,336,Board 2,6x6,500
1486,1194,0.0500516891479492,292,Board 2,6x6,500
1224,906,0.0425341129302978,318,Board 2,6x6,500
3226,2896,0.0985238552093505,330,Board 2,6x6,500
5595,5291,0.1617650985717773,304,Board 2,6x6,500
2294,1956,0.0739729404449462,338,Board 2,6x6,500
4734,4368,0.1419379711151123,366,Board 2,6x6,500
1586,1248,0.0536696910858154,338,Board 2,6x6,500
1127,777,0.0411207675933837,350,Board 2,6x6,500
1477,1101,0.0563750267028808,376,Board 2,6x6,500
1581,1241,0.0533797740936279,340,Board 2,6x6,500
1191,875,0.0406391620635986,316,Board 2,6x6,500
1486,1112,0.0544991493225097,374,Board 2,6x6,500
462,462,0.015071153640747,0,Board 2,6x6,500
700,472,0.0272250175476074,228,Board 2,6x6,500
2424,2108,0.0758440494537353,316,Board 2,6x6,500
700,512,0.0293958187103271,188,Board 2,6x6,500
7583,7247,0.219243049621582,336,Board 2,6x6,500
3808,3482,0.1146469116210937,326,Board 2,6x6,500
853,591,0.030505895614624,262,Board 2,6x6,500
1517,1515,0.0429720878601074,2,Board 2,6x6,500
4214,3866,0.1292910575866699,348,Board 2,6x6,500
1815,1447,0.0617270469665527,368,Board 2,6x6,500
2255,1921,0.0702321529388427,334,Board 2,6x6,500
4960,4626,0.147162914276123,334,Board 2,6x6,500
1244,904,0.0447528362274169,340,Board 2,6x6,500
4711,4361,0.1402120590209961,350,Board 2,6x6,500
2800,2452,0.0858569145202636,348,Board 2,6x6,500
1369,1027,0.0468459129333496,342,Board 2,6x6,500
355,353,0.011815071105957,2,Board 2,6x6,500
503,349,0.0209128856658935,154,Board 2,6x6,500
676,488,0.02726411819458,188,Board 2,6x6,500
1974,1646,0.064033031463623,328,Board 2,6x6,500
1299,949,0.0452761650085449,350,Board 2,6x6,500
1550,1182,0.0601499080657959,368,Board 2,6x6,500
1637,1261,0.055804967880249,376,Board 2,6x6,500
720,522,0.0283842086791992,198,Board 2,6x6,500
1274,934,0.0475409030914306,340,Board 2,6x6,500
1750,1406,0.0589082241058349,344,Board 2,6x6,500
1089,747,0.0396032333374023,342,Board 2,6x6,500
519,381,0.0223281383514404,138,Board 2,6x6,500
1016,730,0.0404548645019531,286,Board 2,6x6,500
1207,1207,0.0348351001739501,0,Board 2,6x6,500
3122,2784,0.0950357913970947,338,Board 2,6x6,500
2196,2196,0.0611786842346191,0,Board 2,6x6,500
3978,3610,0.1206779479980468,368,Board 2,6x6,500
2010,1672,0.065619945526123,338,Board 2,6x6,500
347,241,0.0153028964996337,106,Board 2,6x6,500
2029,2029,0.0572559833526611,0,Board 2,6x6,500
1219,869,0.0428371429443359,350,Board 2,6x6,500
4742,4440,0.1412239074707031,302,Board 2,6x6,500
3120,2784,0.0965387821197509,336,Board 2,6x6,500
967,717,0.0363650321960449,250,Board 2,6x6,500
1340,1340,0.0380659103393554,0,Board 2,6x6,500
2200,2200,0.0618131160736084,0,Board 2,6x6,500
518,518,0.0162749290466308,0,Board 2,6x6,500
965,689,0.036952257156372,276,Board 2,6x6,500
968,712,0.0370771884918212,256,Board 2,6x6,500
1760,1450,0.0571436882019043,310,Board 2,6x6,500
3093,2783,0.0949559211730957,310,Board 2,6x6,500
3826,3506,0.1148138046264648,320,Board 2,6x6,500
4520,4176,0.135599136352539,344,Board 2,6x6,500
5487,5487,0.1502141952514648,0,Board 2,6x6,500
2607,2309,0.0815789699554443,298,Board 2,6x6,500
532,378,0.0219061374664306,154,Board 2,6x6,500
769,537,0.028980016708374,232,Board 2,6x6,500
2590,2272,0.0791521072387695,318,Board 2,6x6,500
2309,1945,0.0726239681243896,364,Board 2,6x6,500
1516,1162,0.0525059700012207,354,Board 2,6x6,500
3014,3014,0.0823690891265869,0,Board 2,6x6,500
4219,4219,0.1160709857940673,0,Board 2,6x6,500
1194,870,0.0414409637451171,324,Board 2,6x6,500
867,625,0.0331151485443115,242,Board 2,6x6,500
204,132,0.0095343589782714,72,Board 2,6x6,500
2549,2549,0.0698440074920654,0,Board 2,6x6,500
6023,5731,0.1745190620422363,292,Board 2,6x6,500
1619,1269,0.0567679405212402,350,Board 2,6x6,500
1265,965,0.0431339740753173,300,Board 2,6x6,500
4441,4101,0.131847858428955,340,Board 2,6x6,500
728,726,0.0216071605682373,2,Board 2,6x6,500
1937,1627,0.0619347095489501,310,Board 2,6x6,500
7190,6872,0.207303762435913,318,Board 2,6x6,500
832,584,0.0314650535583496,248,Board 2,6x6,500
3731,3379,0.1123840808868408,352,Board 2,6x6,500
1089,1089,0.0317497253417968,0,Board 2,6x6,500
1363,1023,0.0461287498474121,340,Board 2,6x6,500
1156,850,0.043044090270996,306,Board 2,6x6,500
3057,2731,0.0950801372528076,326,Board 2,6x6,500
1029,695,0.0366351604461669,334,Board 2,6x6,500
655,655,0.019913911819458,0,Board 2,6x6,500
3866,3864,0.1056632995605468,2,Board 2,6x6,500
799,533,0.0303699970245361,266,Board 2,6x6,500
3392,2990,0.1117827892303466,402,Board 2,6x6,500
6132,5802,0.1775541305541992,330,Board 2,6x6,500
412,280,0.0179018974304199,132,Board 2,6x6,500
333,239,0.0148262977600097,94,Board 2,6x6,500
6791,6791,0.1852936744689941,0,Board 2,6x6,500
1079,769,0.0393159389495849,310,Board 2,6x6,500
1494,1122,0.0546851158142089,372,Board 2,6x6,500
2194,2194,0.0598869323730468,0,Board 2,6x6,500
9074,7808,0.397435188293457,1266,Board 1,6x6,2000
35689,34313,1.40655779838562,1376,Board 1,6x6,2000
13437,12077,0.5740950107574463,1360,Board 1,6x6,2000
17974,16672,0.7108237743377686,1302,Board 1,6x6,2000
15838,14426,0.6484570503234863,1412,Board 1,6x6,2000
307,125,0.0250320434570312,182,Board 1,6x6,2000
21252,19936,0.8230392932891846,1316,Board 1,6x6,2000
7394,6024,0.3372600078582763,1370,Board 1,6x6,2000
1384,790,0.0983321666717529,594,Board 1,6x6,2000
12647,11305,0.5310158729553223,1342,Board 1,6x6,2000
10477,9169,0.4443089962005615,1308,Board 1,6x6,2000
29343,28007,1.1024127006530762,1336,Board 1,6x6,2000
13657,12287,0.5666201114654541,1370,Board 1,6x6,2000
3235,1933,0.1758191585540771,1302,Board 1,6x6,2000
3732,2376,0.2101929187774658,1356,Board 1,6x6,2000
688,386,0.0536739826202392,302,Board 1,6x6,2000
5383,4065,0.25909423828125,1318,Board 1,6x6,2000
10491,9159,0.4506559371948242,1332,Board 1,6x6,2000
2466,1398,0.1480741500854492,1068,Board 1,6x6,2000
14111,12807,0.5791900157928467,1304,Board 1,6x6,2000
2012,1068,0.1248791217803955,944,Board 1,6x6,2000
12945,11603,0.5406830310821533,1342,Board 1,6x6,2000
13945,12621,0.5658769607543945,1324,Board 1,6x6,2000
9059,7771,0.3826291561126709,1288,Board 1,6x6,2000
14527,13151,0.5908291339874268,1376,Board 1,6x6,2000
4429,3077,0.2306251525878906,1352,Board 1,6x6,2000
12901,11567,0.5159900188446045,1334,Board 1,6x6,2000
41329,39963,1.566807985305786,1366,Board 1,6x6,2000
17077,15737,0.6832201480865479,1340,Board 1,6x6,2000
29044,27596,1.1341419219970703,1448,Board 1,6x6,2000
3284,1978,0.1862251758575439,1306,Board 1,6x6,2000
9016,7664,0.3994159698486328,1352,Board 1,6x6,2000
8053,6725,0.3562099933624267,1328,Board 1,6x6,2000
8975,7679,0.3936030864715576,1296,Board 1,6x6,2000
9806,8538,0.4115257263183594,1268,Board 1,6x6,2000
4860,3580,0.2330121994018554,1280,Board 1,6x6,2000
5413,4061,0.2631268501281738,1352,Board 1,6x6,2000
37772,36450,1.4104740619659424,1322,Board 1,6x6,2000
3822,2478,0.2072629928588867,1344,Board 1,6x6,2000
1678,862,0.1045541763305664,816,Board 1,6x6,2000
17940,16684,0.6959958076477051,1256,Board 1,6x6,2000
8357,7115,0.3644700050354004,1242,Board 1,6x6,2000
46430,45086,2.006442070007324,1344,Board 1,6x6,2000
17348,16082,0.6918118000030518,1266,Board 1,6x6,2000
1195,631,0.0895402431488037,564,Board 1,6x6,2000
8971,7629,0.4558162689208984,1342,Board 1,6x6,2000
17685,16363,0.7095308303833008,1322,Board 1,6x6,2000
20485,19183,0.7885010242462158,1302,Board 1,6x6,2000
1789,989,0.1184258460998535,800,Board 1,6x6,2000
25411,23987,0.9914658069610596,1424,Board 1,6x6,2000
10193,8855,0.4334232807159424,1338,Board 1,6x6,2000
14694,13412,0.5904219150543213,1282,Board 1,6x6,2000
885,487,0.0669870376586914,398,Board 1,6x6,2000
12532,11182,0.5127217769622803,1350,Board 1,6x6,2000
10992,9644,0.4725980758666992,1348,Board 1,6x6,2000
26805,25489,1.0189518928527832,1316,Board 1,6x6,2000
16049,14635,0.6401779651641846,1414,Board 1,6x6,2000
15311,13929,0.619300127029419,1382,Board 1,6x6,2000
31671,30319,1.2717180252075195,1352,Board 1,6x6,2000
21657,20347,0.8374300003051758,1310,Board 1,6x6,2000
31922,30534,1.2254242897033691,1388,Board 1,6x6,2000
23680,22344,1.0057058334350586,1336,Board 1,6x6,2000
1363,811,0.1168029308319091,552,Board 1,6x6,2000
28484,27234,1.3157641887664795,1250,Board 1,6x6,2000
20590,19216,1.0084218978881836,1374,Board 1,6x6,2000
7859,6507,0.4242751598358154,1352,Board 1,6x6,2000
13877,12505,0.7209718227386475,1372,Board 1,6x6,2000
10109,8741,0.5334899425506592,1368,Board 1,6x6,2000
14980,13652,0.7345948219299316,1328,Board 1,6x6,2000
11655,10299,0.5838577747344971,1356,Board 1,6x6,2000
21888,20574,1.0260517597198486,1314,Board 1,6x6,2000
16635,15283,0.8310501575469971,1352,Board 1,6x6,2000
5112,3772,0.3033790588378906,1340,Board 1,6x6,2000
7887,6563,0.4044277667999267,1324,Board 1,6x6,2000
7691,6311,0.4157161712646484,1380,Board 1,6x6,2000
7653,6291,0.404822826385498,1362,Board 1,6x6,2000
34615,33373,1.561255931854248,1242,Board 1,6x6,2000
5040,3676,0.3108029365539551,1364,Board 1,6x6,2000
30899,29555,1.3977699279785156,1344,Board 1,6x6,2000
10128,8836,0.520413875579834,1292,Board 1,6x6,2000
13055,11729,0.6567990779876709,1326,Board 1,6x6,2000
1263,709,0.0982038974761962,554,Board 1,6x6,2000
16555,15305,0.651216983795166,1250,Board 1,6x6,2000
6072,4710,0.2995271682739258,1362,Board 1,6x6,2000
26234,24936,1.007326364517212,1298,Board 1,6x6,2000
9736,8394,0.4269778728485107,1342,Board 1,6x6,2000
35261,33919,1.362962007522583,1342,Board 1,6x6,2000
22700,21406,0.8759670257568359,1294,Board 1,6x6,2000
11272,9904,0.4846069812774658,1368,Board 1,6x6,2000
6371,5005,0.308722972869873,1366,Board 1,6x6,2000
6448,5108,0.2998311519622803,1340,Board 1,6x6,2000
8518,7116,0.3746430873870849,1402,Board 1,6x6,2000
5381,3981,0.2759830951690674,1400,Board 1,6x6,2000
11239,9941,0.471027135848999,1298,Board 1,6x6,2000
3660,2306,0.2130379676818847,1354,Board 1,6x6,2000
5296,3956,0.260286808013916,1340,Board 1,6x6,2000
10863,9499,0.457298994064331,1364,Board 1,6x6,2000
14960,13636,0.5963730812072754,1324,Board 1,6x6,2000
8180,6860,0.3663501739501953,1320,Board 1,6x6,2000
1206,652,0.08473801612854,554,Board 1,6x6,2000
6990,5650,0.4064338207244873,1340,Board 2,6x6,2000
2454,1804,0.1928770542144775,650,Board 2,6x6,2000
8713,7323,0.4364333152770996,1390,Board 2,6x6,2000
5778,4446,0.3461496829986572,1332,Board 2,6x6,2000
955,955,0.0380620956420898,0,Board 2,6x6,2000
1794,1206,0.1383619308471679,588,Board 2,6x6,2000
1444,1050,0.1232776641845703,394,Board 2,6x6,2000
2807,2807,0.1000928878784179,0,Board 2,6x6,2000
861,571,0.0719149112701416,290,Board 2,6x6,2000
3904,2664,0.2539510726928711,1240,Board 2,6x6,2000
551,413,0.0530731678009033,138,Board 2,6x6,2000
5108,5108,0.1760990619659423,0,Board 2,6x6,2000
3816,3816,0.1783089637756347,0,Board 2,6x6,2000
262,164,0.0289089679718017,98,Board 2,6x6,2000
1092,1092,0.0474069118499755,0,Board 2,6x6,2000
4942,3576,0.3260719776153564,1366,Board 2,6x6,2000
1367,873,0.1058077812194824,494,Board 2,6x6,2000
3061,2089,0.2132160663604736,972,Board 2,6x6,2000
6126,4760,0.3488497734069824,1366,Board 2,6x6,2000
2358,1660,0.1750578880310058,698,Board 2,6x6,2000
3208,2220,0.2311370372772216,988,Board 2,6x6,2000
5024,3694,0.3069920539855957,1330,Board 2,6x6,2000
1307,919,0.1095340251922607,388,Board 2,6x6,2000
2052,1438,0.1551361083984375,614,Board 2,6x6,2000
2639,1875,0.1978809833526611,764,Board 2,6x6,2000
2063,1451,0.1656250953674316,612,Board 2,6x6,2000
3006,2136,0.2211341857910156,870,Board 2,6x6,2000
401,283,0.0397870540618896,118,Board 2,6x6,2000
4165,2821,0.279412031173706,1344,Board 2,6x6,2000
4534,3202,0.3040850162506103,1332,Board 2,6x6,2000
1404,978,0.1294300556182861,426,Board 2,6x6,2000
2195,2195,0.0886697769165039,0,Board 2,6x6,2000
4795,3461,0.3563179969787597,1334,Board 2,6x6,2000
641,467,0.0716569423675537,174,Board 2,6x6,2000
447,447,0.028249979019165,0,Board 2,6x6,2000
3262,2270,0.2591238021850586,992,Board 2,6x6,2000
4498,3182,0.3284339904785156,1316,Board 2,6x6,2000
3553,2509,0.300441026687622,1044,Board 2,6x6,2000
3868,2660,0.3500971794128418,1208,Board 2,6x6,2000
1335,913,0.1321651935577392,422,Board 2,6x6,2000
749,533,0.086601972579956,216,Board 2,6x6,2000
2530,1770,0.2338242530822754,760,Board 2,6x6,2000
539,379,0.0599370002746582,160,Board 2,6x6,2000
322,238,0.0407671928405761,84,Board 2,6x6,2000
5690,4396,0.4039900302886963,1294,Board 2,6x6,2000
1496,1496,0.0697898864746093,0,Board 2,6x6,2000
1719,1719,0.0785248279571533,0,Board 2,6x6,2000
2004,1396,0.1891319751739502,608,Board 2,6x6,2000
1569,1087,0.1514649391174316,482,Board 2,6x6,2000
927,607,0.0940892696380615,320,Board 2,6x6,2000
1530,1040,0.1491219997406005,490,Board 2,6x6,2000
4479,3163,0.3537023067474365,1316,Board 2,6x6,2000
8593,7309,0.5257358551025391,1284,Board 2,6x6,2000
1131,1131,0.0556979179382324,0,Board 2,6x6,2000
1715,1255,0.1842548847198486,460,Board 2,6x6,2000
2855,1971,0.2407112121582031,884,Board 2,6x6,2000
5786,4482,0.3989560604095459,1304,Board 2,6x6,2000
3978,3978,0.1669771671295166,0,Board 2,6x6,2000
2106,1468,0.1867556571960449,638,Board 2,6x6,2000
6377,5053,0.403501033782959,1324,Board 2,6x6,2000
1198,896,0.1253371238708496,302,Board 2,6x6,2000
2248,2248,0.0933079719543457,0,Board 2,6x6,2000
3941,2745,0.2930700778961181,1196,Board 2,6x6,2000
2084,2084,0.0923221111297607,0,Board 2,6x6,2000
2741,1921,0.2570569515228271,820,Board 2,6x6,2000
4293,2993,0.3268868923187256,1300,Board 2,6x6,2000
966,662,0.1038017272949218,304,Board 2,6x6,2000
3701,2473,0.3089320659637451,1228,Board 2,6x6,2000
825,601,0.095444917678833,224,Board 2,6x6,2000
971,711,0.1045360565185546,260,Board 2,6x6,2000
3224,2308,0.2831788063049316,916,Board 2,6x6,2000
7713,6433,0.463407039642334,1280,Board 2,6x6,2000
891,591,0.0902609825134277,300,Board 2,6x6,2000
2014,1374,0.1877200603485107,640,Board 2,6x6,2000
5960,4656,0.4130010604858398,1304,Board 2,6x6,2000
670,462,0.0717270374298095,208,Board 2,6x6,2000
1454,1018,0.1353180408477783,436,Board 2,6x6,2000
3328,2328,0.2703502178192138,1000,Board 2,6x6,2000
4602,4602,0.1962192058563232,0,Board 2,6x6,2000
4818,3542,0.344153881072998,1276,Board 2,6x6,2000
1594,1594,0.072908878326416,0,Board 2,6x6,2000
1483,1483,0.0713720321655273,0,Board 2,6x6,2000
8510,7098,0.5863442420959473,1412,Board 2,6x6,2000
332,226,0.040083885192871,106,Board 2,6x6,2000
1398,984,0.1392598152160644,414,Board 2,6x6,2000
2165,2165,0.0916879177093505,0,Board 2,6x6,2000
2332,1564,0.2104010581970214,768,Board 2,6x6,2000
717,471,0.0709068775177002,246,Board 2,6x6,2000
1685,1171,0.1628291606903076,514,Board 2,6x6,2000
4122,2898,0.3267090320587158,1224,Board 2,6x6,2000
750,536,0.083730936050415,214,Board 2,6x6,2000
2650,1804,0.2314920425415039,846,Board 2,6x6,2000
831,605,0.0910408496856689,226,Board 2,6x6,2000
740,740,0.0349578857421875,0,Board 2,6x6,2000
944,648,0.0958030223846435,296,Board 2,6x6,2000
2488,2488,0.1033778190612793,0,Board 2,6x6,2000
1160,874,0.1211247444152832,286,Board 2,6x6,2000
2592,1864,0.2449829578399658,728,Board 2,6x6,2000
1255,1255,0.0596039295196533,0,Board 2,6x6,2000
3747,2599,0.3240420818328857,1148,Board 2,6x6,2000
85617,84267,2.9205989837646484,1350,Board 3,6x6,2000
9448,8190,0.4287538528442383,1258,Board 3,6x6,2000
22596,21348,0.8237271308898926,1248,Board 3,6x6,2000
42167,40817,1.4778287410736084,1350,Board 3,6x6,2000
4042,2774,0.255047082901001,1268,Board 3,6x6,2000
22725,21397,0.8479580879211426,1328,Board 3,6x6,2000
35496,35496,1.0147571563720703,0,Board 3,6x6,2000
78388,77054,2.649946928024292,1334,Board 3,6x6,2000
10315,8941,0.4448740482330322,1374,Board 3,6x6,2000
35916,34570,1.2815332412719729,1346,Board 3,6x6,2000
98128,96810,3.2499642372131348,1318,Board 3,6x6,2000
53152,51842,2.1737310886383057,1310,Board 3,6x6,2000
66797,65481,2.2330400943756104,1316,Board 3,6x6,2000
17332,16018,0.6634070873260498,1314,Board 3,6x6,2000
24457,23063,0.9204747676849364,1394,Board 3,6x6,2000
69256,67938,2.2917609214782715,1318,Board 3,6x6,2000
81029,79657,2.740752696990967,1372,Board 3,6x6,2000
7546,6256,0.3565149307250976,1290,Board 3,6x6,2000
30503,29117,1.1040241718292236,1386,Board 3,6x6,2000
65938,64636,2.2309718132019043,1302,Board 3,6x6,2000
15066,13730,0.6427490711212158,1336,Board 3,6x6,2000
7724,6354,0.3767309188842773,1370,Board 3,6x6,2000
40303,38887,1.434316873550415,1416,Board 3,6x6,2000
27845,26449,1.0280578136444092,1396,Board 3,6x6,2000
60481,59099,2.0076379776000977,1382,Board 3,6x6,2000
29234,29234,0.8960268497467041,0,Board 3,6x6,2000
19828,18476,0.7457060813903809,1352,Board 3,6x6,2000
9260,7970,0.4040870666503906,1290,Board 3,6x6,2000
28822,27484,1.0199980735778809,1338,Board 3,6x6,2000
55565,54219,1.856415033340454,1346,Board 3,6x6,2000
26426,25078,0.9529190063476562,1348,Board 3,6x6,2000
58306,57014,1.9192681312561035,1292,Board 3,6x6,2000
64905,63605,2.1700191497802734,1300,Board 3,6x6,2000
48923,47561,1.7032430171966553,1362,Board 3,6x6,2000
17502,16144,0.6672630310058594,1358,Board 3,6x6,2000
16056,14708,0.6320540904998779,1348,Board 3,6x6,2000
24309,22981,0.8768250942230225,1328,Board 3,6x6,2000
10880,9574,0.4586329460144043,1306,Board 3,6x6,2000
16984,15654,0.64935302734375,1330,Board 3,6x6,2000
5998,4660,0.3035931587219238,1338,Board 3,6x6,2000
13140,13138,0.3823089599609375,2,Board 3,6x6,2000
47440,46120,1.598684787750244,1320,Board 3,6x6,2000
39632,38178,1.3842229843139648,1454,Board 3,6x6,2000
61593,61593,1.769981861114502,0,Board 3,6x6,2000
46227,44915,1.5554640293121338,1312,Board 3,6x6,2000
8328,8328,0.2466919422149658,0,Board 3,6x6,2000
9539,8181,0.4180090427398681,1358,Board 3,6x6,2000
29500,28152,1.032829999923706,1348,Board 3,6x6,2000
71420,71420,2.0441970825195312,0,Board 3,6x6,2000
21015,19661,0.7944231033325195,1354,Board 3,6x6,2000
8512,7138,0.4160070419311523,1374,Board 3,6x6,2000
3784,2572,0.2314498424530029,1212,Board 3,6x6,2000
15211,15211,0.441478967666626,0,Board 3,6x6,2000
11611,11611,0.336500883102417,0,Board 3,6x6,2000
57484,57484,1.645457744598389,0,Board 3,6x6,2000
14348,14348,0.4178197383880615,0,Board 3,6x6,2000
66559,65205,2.2234628200531006,1354,Board 3,6x6,2000
4528,3202,0.2693459987640381,1326,Board 3,6x6,2000
43937,42581,1.4950318336486816,1356,Board 3,6x6,2000
2626,1734,0.1975488662719726,892,Board 3,6x6,2000
12769,11451,0.5314188003540039,1318,Board 3,6x6,2000
40296,38940,1.3812389373779297,1356,Board 3,6x6,2000
6268,4906,0.3386991024017334,1362,Board 3,6x6,2000
10154,8816,0.4545300006866455,1338,Board 3,6x6,2000
38215,38215,1.0993280410766602,0,Board 3,6x6,2000
46546,45208,1.579700231552124,1338,Board 3,6x6,2000
52301,50957,1.7414779663085938,1344,Board 3,6x6,2000
30314,29060,1.045708179473877,1254,Board 3,6x6,2000
64087,62789,2.1010091304779053,1298,Board 3,6x6,2000
8516,7228,0.3952450752258301,1288,Board 3,6x6,2000
85364,84020,2.754922151565552,1344,Board 3,6x6,2000
31263,31261,0.9003729820251465,2,Board 3,6x6,2000
19045,17681,0.7342431545257568,1364,Board 3,6x6,2000
5465,4147,0.296339750289917,1318,Board 3,6x6,2000
31885,30541,1.124119997024536,1344,Board 3,6x6,2000
19328,19326,0.5695018768310547,2,Board 3,6x6,2000
25271,23905,0.934678077697754,1366,Board 3,6x6,2000
27084,25744,0.9741618633270264,1340,Board 3,6x6,2000
54415,52975,1.8460111618041992,1440,Board 3,6x6,2000
12781,11533,0.5086948871612549,1248,Board 3,6x6,2000
79970,78646,2.571687936782837,1324,Board 3,6x6,2000
51294,49948,1.748150110244751,1346,Board 3,6x6,2000
43222,41898,1.49222993850708,1324,Board 3,6x6,2000
11878,10520,0.4853041172027588,1358,Board 3,6x6,2000
8256,6874,0.3927259445190429,1382,Board 3,6x6,2000
17180,15822,0.6757118701934814,1358,Board 3,6x6,2000
33945,33945,0.97947096824646,0,Board 3,6x6,2000
65353,64025,2.1669137477874756,1328,Board 3,6x6,2000
14686,13256,0.6144630908966064,1430,Board 3,6x6,2000
5158,3822,0.2936840057373047,1336,Board 3,6x6,2000
18274,16932,0.7137398719787598,1342,Board 3,6x6,2000
16774,15424,0.637876033782959,1350,Board 3,6x6,2000
29089,27707,1.0450458526611328,1382,Board 3,6x6,2000
19603,18205,0.7481539249420166,1398,Board 3,6x6,2000
57833,56489,1.9202239513397217,1344,Board 3,6x6,2000
20351,19035,0.7438561916351318,1316,Board 3,6x6,2000
13643,13643,0.3971269130706787,0,Board 3,6x6,2000
13909,12579,0.5599219799041748,1330,Board 3,6x6,2000
95301,93955,3.1048848628997803,1346,Board 3,6x6,2000
81608,80244,8.10199499130249,1364,Board 7,12x12,2000
37374,37374,3.2938668727874756,0,Board 7,12x12,2000
57985,56611,6.014825105667114,1374,Board 7,12x12,2000
33334,31990,3.663984060287475,1344,Board 7,12x12,2000
78173,76787,7.832184791564941,1386,Board 7,12x12,2000
38863,37501,4.142378091812134,1362,Board 7,12x12,2000
80725,79421,8.110082864761353,1304,Board 7,12x12,2000
12076,11054,1.7428431510925293,1022,Board 7,12x12,2000
82657,81355,8.319206953048706,1302,Board 7,12x12,2000
26567,25193,3.1208691596984863,1374,Board 7,12x12,2000
30563,29217,3.470656156539917,1346,Board 7,12x12,2000
67310,65914,6.9903271198272705,1396,Board 7,12x12,2000
61428,60122,6.3661158084869385,1306,Board 7,12x12,2000
66394,64982,6.959022045135498,1412,Board 7,12x12,2000
42856,41562,4.68416690826416,1294,Board 7,12x12,2000
91844,90506,9.24839687347412,1338,Board 7,12x12,2000
12608,11448,1.770129919052124,1160,Board 7,12x12,2000
53618,53616,4.897447109222412,2,Board 7,12x12,2000
33674,32278,3.911519050598145,1396,Board 7,12x12,2000
32364,31048,3.6739988327026367,1316,Board 7,12x12,2000
21362,20028,3.064805030822754,1334,Board 7,12x12,2000
50663,50663,5.936627149581909,0,Board 7,12x12,2000
70196,68840,8.368568181991577,1356,Board 7,12x12,2000
52373,51031,5.727966070175171,1342,Board 7,12x12,2000
49572,48200,5.423076868057251,1372,Board 7,12x12,2000
54444,53102,5.875298976898193,1342,Board 7,12x12,2000
89259,87891,9.047359943389893,1368,Board 7,12x12,2000
99943,98551,10.122087001800535,1392,Board 7,12x12,2000
56144,54786,5.893013000488281,1358,Board 7,12x12,2000
15483,14131,2.063293933868408,1352,Board 7,12x12,2000
77210,75912,7.7603631019592285,1298,Board 7,12x12,2000
76649,75285,7.95065975189209,1364,Board 7,12x12,2000
75317,73931,8.090963125228882,1386,Board 7,12x12,2000
46513,45235,5.38784122467041,1278,Board 7,12x12,2000
10284,9290,1.5943078994750977,994,Board 7,12x12,2000
59788,58492,6.320803880691528,1296,Board 7,12x12,2000
83355,82041,8.39135217666626,1314,Board 7,12x12,2000
27886,26578,2.919343948364258,1308,Board 7,12x12,2000
29350,27988,3.5264861583709717,1362,Board 7,12x12,2000
96458,95130,8.664005041122437,1328,Board 7,12x12,2000
4865,4415,0.707266092300415,450,Board 7,12x12,2000
74882,73558,6.791326999664307,1324,Board 7,12x12,2000
33698,32340,3.4116010665893555,1358,Board 7,12x12,2000
25030,25030,1.982551097869873,0,Board 7,12x12,2000
32462,31142,3.2486181259155273,1320,Board 7,12x12,2000
73671,72277,6.6339592933654785,1394,Board 7,12x12,2000
58714,57324,5.801442861557007,1390,Board 7,12x12,2000
31795,30447,3.0658559799194336,1348,Board 7,12x12,2000
44028,42704,3.8308141231536865,1324,Board 7,12x12,2000
26240,24944,2.477916717529297,1296,Board 7,12x12,2000
59307,59307,4.435701131820679,0,Board 7,12x12,2000
60100,58742,5.13019585609436,1358,Board 7,12x12,2000
16284,14946,1.6913650035858154,1338,Board 7,12x12,2000
67339,65959,5.8353400230407715,1380,Board 7,12x12,2000
72930,71646,6.522578001022339,1284,Board 7,12x12,2000
94313,92899,8.418673038482666,1414,Board 7,12x12,2000
45610,45610,3.5949649810791016,0,Board 7,12x12,2000
48000,46692,4.221689224243164,1308,Board 7,12x12,2000
57148,55820,5.341915845870972,1328,Board 7,12x12,2000
45823,44533,4.610744953155518,1290,Board 7,12x12,2000
15466,14054,1.9738340377807615,1412,Board 7,12x12,2000
11906,10870,1.6739580631256104,1036,Board 7,12x12,2000
34529,33181,3.968303203582764,1348,Board 7,12x12,2000
48577,47199,5.11854887008667,1378,Board 7,12x12,2000
4975,4457,0.787757158279419,518,Board 7,12x12,2000
60140,58830,6.127511739730835,1310,Board 7,12x12,2000
56907,55535,5.889219045639038,1372,Board 7,12x12,2000
8879,7997,1.285249948501587,882,Board 7,12x12,2000
63306,61946,6.750179052352905,1360,Board 7,12x12,2000
52919,51493,6.0118279457092285,1426,Board 7,12x12,2000
72410,71078,7.642578125,1332,Board 7,12x12,2000
87550,86242,9.603946924209597,1308,Board 7,12x12,2000
21992,20688,1.7649481296539309,1304,Board 6,9x9,2000
68274,66824,4.588347911834717,1450,Board 6,9x9,2000
11849,10535,1.156816005706787,1314,Board 6,9x9,2000
57569,56191,4.307958126068115,1378,Board 6,9x9,2000
92370,91072,6.019531965255737,1298,Board 6,9x9,2000
7117,6189,0.7435719966888428,928,Board 6,9x9,2000
19932,18542,1.5700559616088867,1390,Board 6,9x9,2000
63255,61951,4.173019886016846,1304,Board 6,9x9,2000
24965,23557,1.8572988510131836,1408,Board 6,9x9,2000
5149,4479,0.5492632389068604,670,Board 6,9x9,2000
35581,34213,2.4775478839874268,1368,Board 6,9x9,2000
16988,15682,1.3505537509918213,1306,Board 6,9x9,2000
25958,24582,1.874526023864746,1376,Board 6,9x9,2000
20269,18943,1.5671799182891846,1326,Board 6,9x9,2000
56855,55579,3.702360153198242,1276,Board 6,9x9,2000
35863,34537,3.435037851333618,1326,Board 6,9x9,2000
15013,13625,2.207198143005371,1388,Board 6,9x9,2000
21634,20320,2.291917085647583,1314,Board 6,9x9,2000
16091,14763,1.4921221733093262,1328,Board 6,9x9,2000
21460,20152,1.866535186767578,1308,Board 6,9x9,2000
59142,57838,4.4498748779296875,1304,Board 6,9x9,2000
36627,35331,2.7010278701782227,1296,Board 6,9x9,2000
13045,11699,1.4904742240905762,1346,Board 6,9x9,2000
18371,17025,1.758453130722046,1346,Board 6,9x9,2000
24588,23232,2.004586935043335,1356,Board 6,9x9,2000
37309,35907,2.8736751079559326,1402,Board 6,9x9,2000
5480,4752,0.6398699283599854,728,Board 6,9x9,2000
24718,23342,1.9715991020202637,1376,Board 6,9x9,2000
19890,18602,1.7874901294708252,1288,Board 6,9x9,2000
6774,5906,0.931781768798828,868,Board 6,9x9,2000
25162,23870,2.1612179279327393,1292,Board 6,9x9,2000
43681,42331,3.6095240116119385,1350,Board 6,9x9,2000
44429,43051,3.331655263900757,1378,Board 6,9x9,2000
12418,11106,1.1673362255096436,1312,Board 6,9x9,2000
6193,5451,0.7006866931915283,742,Board 6,9x9,2000
6506,5608,0.7756698131561279,898,Board 6,9x9,2000
25811,24403,2.105360984802246,1408,Board 6,9x9,2000
44167,42867,3.4717512130737305,1300,Board 6,9x9,2000
14075,12689,1.3786380290985107,1386,Board 6,9x9,2000
11299,9931,1.3170208930969238,1368,Board 6,9x9,2000
17340,15956,1.607111930847168,1384,Board 6,9x9,2000
77261,75931,6.089712858200073,1330,Board 6,9x9,2000
35019,33677,3.276298761367798,1342,Board 6,9x9,2000
5622,4828,0.6743662357330322,794,Board 6,9x9,2000
35822,34508,2.7010691165924072,1314,Board 6,9x9,2000
9549,9549,0.6229581832885742,0,Board 6,9x9,2000
34498,33206,2.639684677124023,1292,Board 6,9x9,2000
10411,9097,1.054401159286499,1314,Board 6,9x9,2000
21431,20151,1.759230136871338,1280,Board 6,9x9,2000
17654,17654,1.1559648513793943,0,Board 6,9x9,2000
29389,28039,2.5452001094818115,1350,Board 6,9x9,2000
31758,30422,2.512253999710083,1336,Board 6,9x9,2000
27178,25938,2.156106948852539,1240,Board 6,9x9,2000
70365,68997,5.505795001983643,1368,Board 6,9x9,2000
30487,29111,2.506089210510254,1376,Board 6,9x9,2000
20175,18869,1.9420998096466064,1306,Board 6,9x9,2000
26781,25487,2.0976319313049316,1294,Board 6,9x9,2000
9706,8448,1.2067599296569824,1258,Board 6,9x9,2000
14863,13483,1.6584079265594482,1380,Board 6,9x9,2000
13320,12000,1.393521070480347,1320,Board 6,9x9,2000
7728,6708,0.981525182723999,1020,Board 6,9x9,2000
75751,74351,6.103675127029419,1400,Board 6,9x9,2000
20973,19687,1.878298282623291,1286,Board 6,9x9,2000
20745,19359,2.0229969024658203,1386,Board 6,9x9,2000
23171,21809,2.039992094039917,1362,Board 6,9x9,2000
19761,19761,1.185258865356445,0,Board 6,9x9,2000
23737,22449,1.883988857269287,1288,Board 6,9x9,2000
11844,10466,1.2232933044433594,1378,Board 6,9x9,2000
51440,50104,3.3594279289245605,1336,Board 6,9x9,2000
2002,1706,0.2898550033569336,296,Board 6,9x9,2000
89220,87976,5.443494081497192,1244,Board 6,9x9,2000
48678,47308,3.487301826477051,1370,Board 6,9x9,2000
12170,10830,1.2756648063659668,1340,Board 6,9x9,2000
41831,40427,2.9123740196228027,1404,Board 6,9x9,2000
23231,21919,1.7521378993988037,1312,Board 6,9x9,2000
21640,20184,1.634941816329956,1456,Board 6,9x9,2000
10813,9497,1.067317008972168,1316,Board 6,9x9,2000
2267,1945,0.2809860706329345,322,Board 6,9x9,2000
9694,8570,0.9782164096832277,1124,Board 6,9x9,2000
26933,25577,1.985959768295288,1356,Board 6,9x9,2000
24264,22932,1.7444748878479004,1332,Board 6,9x9,2000
20237,18875,1.494278907775879,1362,Board 6,9x9,2000
24312,22964,1.6810870170593262,1348,Board 6,9x9,2000
22602,21276,1.6319067478179932,1326,Board 6,9x9,2000
3685,3219,0.3995542526245117,466,Board 6,9x9,2000
79914,78566,4.894538640975952,1348,Board 6,9x9,2000
25640,24334,1.696375846862793,1306,Board 6,9x9,2000
34387,33021,2.511086940765381,1366,Board 6,9x9,2000
10202,8940,1.0231330394744873,1262,Board 6,9x9,2000
40420,39132,2.844022035598755,1288,Board 6,9x9,2000
22773,21443,1.6295099258422852,1330,Board 6,9x9,2000
23956,22614,1.877159118652344,1342,Board 6,9x9,2000
4146,3520,0.4414319992065429,626,Board 6,9x9,2000
58498,57174,3.881722211837769,1324,Board 6,9x9,2000
5154,4502,0.5839879512786865,652,Board 6,9x9,2000
25671,24385,1.9492368698120115,1286,Board 6,9x9,2000
16861,15499,1.401916742324829,1362,Board 6,9x9,2000
9062,7906,0.8990411758422852,1156,Board 6,9x9,2000
18503,15749,1.959158018,2754,Board 6,9x9,2000
29000,27606,1.9223480224609375,1394,Board 4,9x9,2000
34665,34665,1.7649478912353516,0,Board 4,9x9,2000
15276,15276,0.7522737979888916,0,Board 4,9x9,2000
30184,28824,1.878343105316162,1360,Board 4,9x9,2000
25324,23954,1.596581220626831,1370,Board 4,9x9,2000
46839,45417,2.806123971939087,1422,Board 4,9x9,2000
92726,92726,4.758374214172363,0,Board 4,9x9,2000
19269,19269,0.9539341926574708,0,Board 4,9x9,2000
39961,38557,2.410166025161743,1404,Board 4,9x9,2000
30624,29324,1.9430162906646729,1300,Board 4,9x9,2000
33218,31922,2.0453529357910156,1296,Board 4,9x9,2000
26770,25464,1.636687994003296,1306,Board 4,9x9,2000
8920,7620,0.6795721054077148,1300,Board 4,9x9,2000
82264,80982,4.583274126052856,1282,Board 4,9x9,2000
41765,40481,2.211455821990967,1284,Board 4,9x9,2000
58438,57098,3.095489978790283,1340,Board 4,9x9,2000
18671,17275,1.2244079113006592,1396,Board 4,9x9,2000
88327,86945,4.434392690658569,1382,Board 4,9x9,2000
34324,33010,1.8509180545806885,1314,Board 4,9x9,2000
16489,15183,0.982774019241333,1306,Board 4,9x9,2000
12478,11254,0.793226957321167,1224,Board 4,9x9,2000
96512,95144,4.829885244369507,1368,Board 4,9x9,2000
69183,67867,3.894834041595459,1316,Board 4,9x9,2000
26369,25099,1.52223801612854,1270,Board 4,9x9,2000
42560,41218,2.270218849182129,1342,Board 4,9x9,2000
10812,9498,0.7272069454193115,1314,Board 4,9x9,2000
10929,9725,0.6931419372558594,1204,Board 4,9x9,2000
61019,59655,3.131233930587769,1364,Board 4,9x9,2000
82566,81216,4.051107168197632,1350,Board 4,9x9,2000
32252,30968,1.5969300270080566,1284,Board 4,9x9,2000
8590,7202,0.5902848243713379,1388,Board 4,9x9,2000
29230,27942,1.4389050006866455,1288,Board 4,9x9,2000
23528,23528,0.9394760131835938,0,Board 4,9x9,2000
33068,31752,1.5701429843902588,1316,Board 4,9x9,2000
24283,22933,1.2269301414489746,1350,Board 4,9x9,2000
71932,70612,3.2022171020507812,1320,Board 4,9x9,2000
70658,69324,3.7671523094177246,1334,Board 4,9x9,2000
58138,56804,3.3710579872131348,1334,Board 4,9x9,2000
14437,13139,0.9733188152313232,1298,Board 4,9x9,2000
27401,26123,1.7353510856628418,1278,Board 4,9x9,2000
16555,15211,1.3379237651824951,1344,Board 4,9x9,2000
56062,54672,3.4264771938323975,1390,Board 4,9x9,2000
23137,21817,1.4595599174499512,1320,Board 4,9x9,2000
38852,38852,1.917585849761963,0,Board 4,9x9,2000
13121,11747,0.9902429580688475,1374,Board 4,9x9,2000
24720,23386,1.5922770500183103,1334,Board 4,9x9,2000
48548,47146,2.9242007732391357,1402,Board 4,9x9,2000
32655,31389,1.9598159790039065,1266,Board 4,9x9,2000
50183,48845,2.8885560035705566,1338,Board 4,9x9,2000
46337,45011,2.6486830711364746,1326,Board 4,9x9,2000
21890,20534,1.4185230731964111,1356,Board 4,9x9,2000
37287,35905,2.2233879566192627,1382,Board 4,9x9,2000
12969,12969,0.6600210666656494,0,Board 4,9x9,2000
15010,13708,1.0748610496520996,1302,Board 4,9x9,2000
32245,30847,3.5213510990142822,1398,Board 4,9x9,2000
33187,31809,3.2252233028411865,1378,Board 4,9x9,2000
25030,23670,1.868354082107544,1360,Board 4,9x9,2000
33420,32048,2.433722734451294,1372,Board 4,9x9,2000
20669,19297,1.7282500267028809,1372,Board 4,9x9,2000
65412,64074,4.083801031112671,1338,Board 4,9x9,2000
11030,9724,0.8824281692504883,1306,Board 4,9x9,2000
37770,36454,2.76554012298584,1316,Board 4,9x9,2000
33812,32470,2.271977186203003,1342,Board 4,9x9,2000
45113,43751,3.0378828048706055,1362,Board 4,9x9,2000
39754,38408,2.638435125350952,1346,Board 4,9x9,2000
68354,66996,4.180211067199707,1358,Board 4,9x9,2000
37806,36434,2.6255128383636475,1372,Board 4,9x9,2000
41424,40092,2.9126996994018555,1332,Board 4,9x9,2000
17222,15924,1.3951411247253418,1298,Board 4,9x9,2000
53909,52509,3.586107015609741,1400,Board 4,9x9,2000
23342,22050,1.6012661457061768,1292,Board 4,9x9,2000
11835,10537,0.9058420658111572,1298,Board 4,9x9,2000
36219,34923,2.3567311763763428,1296,Board 4,9x9,2000
67981,66669,4.166475057601929,1312,Board 4,9x9,2000
53297,51961,3.7676851749420166,1336,Board 4,9x9,2000
26929,25581,1.822890043258667,1348,Board 4,9x9,2000
50366,49040,3.437969207763672,1326,Board 4,9x9,2000
43952,42588,3.5172359943389893,1364,Board 4,9x9,2000
22203,20891,1.6380560398101809,1312,Board 4,9x9,2000
54797,53483,3.563493251800537,1314,Board 4,9x9,2000
18250,16902,1.3497939109802246,1348,Board 4,9x9,2000
21687,20375,1.532912254333496,1312,Board 4,9x9,2000
60937,59665,3.934770107269287,1272,Board 4,9x9,2000
58242,56996,4.09958815574646,1246,Board 4,9x9,2000
43520,43516,2.4646830558776855,4,Board 4,9x9,2000
25184,23802,1.889693260192871,1382,Board 4,9x9,2000
58760,57426,3.9589672088623047,1334,Board 4,9x9,2000
11603,10183,1.1184849739074707,1420,Board 4,9x9,2000
39253,37907,3.0637359619140625,1346,Board 4,9x9,2000
15856,14578,1.244109869003296,1278,Board 4,9x9,2000
41740,40426,3.1591930389404297,1314,Board 4,9x9,2000
24085,22865,1.7154560089111328,1220,Board 4,9x9,2000
52008,52008,3.2000577449798584,0,Board 4,9x9,2000
42825,41459,2.9130821228027344,1366,Board 4,9x9,2000
28582,27276,1.6630661487579346,1306,Board 5,9x9,2000
22975,21543,1.6636669635772705,1432,Board 5,9x9,2000
27344,25956,1.860098123550415,1388,Board 5,9x9,2000
56404,55142,3.691762924194336,1262,Board 5,9x9,2000
20349,18955,1.644953966140747,1394,Board 5,9x9,2000
54414,53102,3.596471071243286,1312,Board 5,9x9,2000
16638,15254,1.2533371448516846,1384,Board 5,9x9,2000
72893,71565,4.414813041687012,1328,Board 5,9x9,2000
2744,2260,0.3040118217468261,484,Board 5,9x9,2000
41841,40519,2.6962890625,1322,Board 5,9x9,2000
56469,55159,3.3867080211639404,1310,Board 5,9x9,2000
34678,33322,2.272103071212769,1356,Board 5,9x9,2000
60945,59619,3.696483850479126,1326,Board 5,9x9,2000
67853,66605,4.136615037918091,1248,Board 5,9x9,2000
16556,15180,1.400173902511597,1376,Board 5,9x9,2000
36994,35644,2.976277112960815,1350,Board 5,9x9,2000
62074,60722,4.32214093208313,1352,Board 5,9x9,2000
7942,6660,0.7141668796539307,1282,Board 5,9x9,2000
32188,30934,2.192596912384033,1254,Board 5,9x9,2000
49210,47846,3.736847162246704,1364,Board 5,9x9,2000
7242,6174,0.8877370357513428,1068,Board 5,9x9,2000
49888,48558,3.616255044937134,1330,Board 5,9x9,2000
6111,5189,0.6953017711639404,922,Board 5,9x9,2000
27283,26013,2.138025999069214,1270,Board 5,9x9,2000
77289,76041,5.0379638671875,1248,Board 5,9x9,2000
3394,2888,0.3941318988800049,506,Board 5,9x9,2000
18837,17479,1.4701497554779053,1358,Board 5,9x9,2000
42566,41206,3.121164083480835,1360,Board 5,9x9,2000
50566,49188,3.630077123641968,1378,Board 5,9x9,2000
90130,88830,6.564464807510376,1300,Board 5,9x9,2000
23989,22713,2.230414628982544,1276,Board 5,9x9,2000
3436,2858,0.4499680995941162,578,Board 5,9x9,2000
69110,67764,4.632998943328857,1346,Board 5,9x9,2000
19031,17713,1.434501886367798,1318,Board 5,9x9,2000
17244,15878,1.4394469261169434,1366,Board 5,9x9,2000
18079,16717,1.468554973602295,1362,Board 5,9x9,2000
19837,18487,1.5703763961791992,1350,Board 5,9x9,2000
80001,78659,5.731411933898926,1342,Board 5,9x9,2000
17223,15905,1.5309298038482666,1318,Board 5,9x9,2000
85130,83862,6.1956470012664795,1268,Board 5,9x9,2000
16438,15100,1.563467025756836,1338,Board 5,9x9,2000
36092,34726,2.8385138511657715,1366,Board 5,9x9,2000
32937,32937,2.240963935852051,0,Board 5,9x9,2000
4324,3592,0.5822639465332031,732,Board 5,9x9,2000
4476,3766,0.5356929302215576,710,Board 5,9x9,2000
28746,27374,2.183298110961914,1372,Board 5,9x9,2000
19482,18206,1.3512489795684814,1276,Board 5,9x9,2000
12465,11131,1.0674359798431396,1334,Board 5,9x9,2000
25783,24463,1.8841652870178225,1320,Board 5,9x9,2000
38439,37137,2.401373863220215,1302,Board 5,9x9,2000
2888,2886,0.173720121383667,2,Board 5,9x9,2000
14807,13481,1.187519073486328,1326,Board 5,9x9,2000
81018,79622,4.846451044082642,1396,Board 5,9x9,2000
27679,26327,1.9054877758026123,1352,Board 5,9x9,2000
6274,5348,0.6371667385101318,926,Board 5,9x9,2000
20954,19594,1.4263179302215576,1360,Board 5,9x9,2000
88146,86832,4.916912794113159,1314,Board 5,9x9,2000
55564,54266,3.3463211059570312,1298,Board 5,9x9,2000
49820,48518,2.864967107772827,1302,Board 5,9x9,2000
62871,61499,3.90421986579895,1372,Board 5,9x9,2000
20200,18926,1.480159044265747,1274,Board 5,9x9,2000
59311,57963,3.5924768447875977,1348,Board 5,9x9,2000
97415,96095,5.982010841369629,1320,Board 5,9x9,2000
35653,34347,2.3321990966796875,1306,Board 5,9x9,2000
67991,66661,3.946992874145508,1330,Board 5,9x9,2000
38720,37362,2.5472772121429443,1358,Board 5,9x9,2000
38754,37458,2.408294200897217,1296,Board 5,9x9,2000
48071,46747,2.917506694793701,1324,Board 5,9x9,2000
45150,43800,2.8258700370788574,1350,Board 5,9x9,2000
31898,30572,1.9663758277893064,1326,Board 5,9x9,2000
21493,20249,1.5003631114959717,1244,Board 5,9x9,2000
47079,45855,2.6807072162628174,1224,Board 5,9x9,2000
39679,38405,2.360821008682251,1274,Board 5,9x9,2000
18021,16687,1.282548904418945,1334,Board 5,9x9,2000
27627,26299,1.972505807876587,1328,Board 5,9x9,2000
51193,49837,3.0681750774383545,1356,Board 5,9x9,2000
11436,10004,1.1445281505584717,1432,Board 5,9x9,2000
25833,24453,1.6308050155639648,1380,Board 5,9x9,2000
59166,57832,3.484847068786621,1334,Board 5,9x9,2000
22798,21490,1.4841279983520508,1308,Board 5,9x9,2000
53282,52006,2.991683006286621,1276,Board 5,9x9,2000
38150,36810,2.1736090183258057,1340,Board 5,9x9,2000
12897,11631,0.8949246406555176,1266,Board 5,9x9,2000
9449,8151,0.7257080078125,1298,Board 5,9x9,2000
31325,29945,1.9009439945220947,1380,Board 5,9x9,2000
7234,6034,0.6735429763793945,1200,Board 5,9x9,2000
55559,54217,3.0377511978149414,1342,Board 5,9x9,2000
